                             ╞╦╗╥╠  ║ ╞╗╔                          
                             ╠╬╬╬╣ ╞╣ ╬╬║ ╥                        
                            ╩╩╬╩╬╝╔╦╬╗║╠╩═╣                        
                              ╚╩╚╗╠╬╩╬╩╬╦╗╠╦╗                      
                              ╔╗ ╠╩╣ ╠╦╩╩╬╬╬╣╥                     
                              ╚╩╦╣╬╝╬╣╣ ╥╠╩╬╬╩═╗                   
                                ╚╩╣  ╠╡ ╚╝ ╠╨╣ ║                   
                                 ╞╣  ╠╗ ╞╗╗╗   ╠╡                  
                                 ╞╣  ║╬ ╚╩╬╬╗ ╔╬╗                  
                                  ╠═╦║   ╔╩╣╚╗║╩╣  ╔╦              
                                  ╨ ╠╩╡ ╬╣ ╠╔╬╦╦╩═╦║  ╥            
                                    ╠╗ ╔═╩═╣╠╬╠╔╩╦╬╠╦╦╣            
                                    ║╠╦╣ ╔═╬╣╠╬╬╦╬╬╣╠╬╝╞╦╡         
                                   ═╬╬╝╠═╩═╩╦╝╚╬╩╩╬╬╩╬═╗║          
                                   ╥║╨ ╚ ╥╚═╝  ║ ╥║╠╦╩╦╩╣          
                               ╦   ╠╝╔╦╗║╣    ╦╬╦╬╬╬╬═╬╣╠╦╡        
                               ╚╗╥╔╣╞╩╬╬╩╣     ╬╠╣╠╬╩╦╩╬╬╝         
                               ╩╣╬╬╝ ╠╬╩╦╬╦╡    ╬╩╝╠╗╩╦╬╣╔═╝       
                                ║╣╚╗╔╣╚═╣╠╠╗   ╔╣ ╥║╬ ╠╬╝║         
                               ╩╩╬╦╬╩╩╦═╬╩╣╬╡╦╦╬╬╦╠╣╬╦╬╬╦╝         
                                ╞╝╣╬╗ ║╞╩╦╣╩╦╦╬╬╬╚╬╬╩╬╩╩╝          
                                  ╠╩╩═╬╗ ╨╠═╣╠╣║║ ╠╬╦╣   ╦         
                                 ╩╩   ╚╩╣ ║╞╩╬╠╬╬╦╬╩╩╝ ╬ ╠╗        
                                  ╩    ╔╬═╩══╬╣╩╬╠╣║   ╠═╬╣    ╣   
                                       ║╩╦═╡ ╠╝╔╠╬╬╬╔╗╥║╦╬╬╗   ║   
                    ╥      ╥           ╠╡╣   ╚╗╠╬╠╩╬╠╬╣╠═╣╚╩═╦╦╣   
             ╥═╗╬╥  ╠╗   ╔╦╣     ╔╗    ║ ╠╦╥ ╔╚╬╠╬╠╩╣╠╬╬╡║ ╠ ╚╩╩╗  
         ╦ ╔╬╬╦╬╝╠╗╞╠╣╬ ╔╬╬╬╗    ╠╣╗ ╥╥╚═╬╡╠╥╠╦╠╬╬╣╞╩╬╩╝ ║     ╞╝  
         ╠╗╨╣╩╬╣╠╬╣ ╚╣╗╦╬╣╠╬╬╡   ║╚╩╦╬╬╗ ╝╔╬╬╠╠╠╬╬╬╗╞╣   ╨         
         ╬╣ ╚╦╣╬╦╬╝ ╠╩╣╬╬╣╠╣╣   ╔╣ ╔╬╩╝╠╡╞╣╠╠╩╬╬╬╩╬╣ ║             
         ╔╬╦ ╚╬╩╬╣ ╔╝║╬╣╣╚╬╬╝╔╦╦╬╣╔╬╣  ╠═╦╬╬╬╦╩╬╬╬╬╣╬╣             
         ╨╚╬╗╞╣ ╚╬╦╣╞╩╬╣║ ║║ ╠╬╬╩╩╝╠╩╗╥╚═╣╠╬╝╠═╩╬╬╩╝ ╚╬            
           ║  ║ ╣╠═╩╗ ╚╩╬╦╣╠╦╬╬╣╞╦╦╣ ║║╔╦╬╠╩╦╝╔═╬║                 
       ╥   ╠╗ ╠═╣╠══╦╬╦╦╬╩╩╣╚╩╬╬╦╣║╠═╬╬╬╬╬╬╝╠╬╬╗║║                 
       ╚╗ ╗╚╬╦╩╦╩╣╗╩╣╦╬╬╬╡ ║  ║╠╩╬╩╣╗╠╬╩╣╠╠╦╣╠╩╣╠╝╥                
       ╠╬╦╩╦╩╬╦╬╦╬╬╦╬╣╬╬╠╗╥╠═╦╬╬╦╬═╣╠╬╩═╬╠╬╣╠╣╔╝║ ║                
        ╨╨ ╚╬╠╝╠╬╦╦╩╬╬╬╬╬╬╣╠╦╩╬╣╠╣ ╠╬╣ ╔╠╬╬╬╬╩╣ ╠╗║╠     ╦╗        
            ╚╬═╬╣╬╣ ║╣╚╩╬╬╣╚╗═╬╬╬╩╗║╚╦╗╠╩╣╠╬╬═╣ ╠╠╩╣    ╞╣║        
             ╠╦╩╣╣╬═╬╩╦╦╝║╠╦╬═╬╩╦╗╠╝ ╚╬╬╡╠╩╣╠═╣ ╠╠╝╨ ╞╦╥ ╠╣        
             ╠╝ ║╬╩╡╠═╩╬╦╬╩╩╩═╩╦╣╠╝   ╚╣╔╩╗╬╬╦╬╦╩╩╦╦╗ ╠╬╦╬╣╥       
             ╝  ╠╩╦═╬╦╗╔╬╣   ╚╦╩╬╩╗    ╨╨ ╠╬╬╬╗╣ ╔╠╬╩╦╩╬╩╬╔╝       
               ╬╩╦╬╗╚╩╠╬╬╬╗ ╔═╬╦╬╦╬╦╗ ╦═╦╦╬╬╣╚╩╬╦╬╝╠╦╬╦╬╗╚╩╬       
      ╞╗   ╔  ╚╣ ╠╣╨  ║╠╬╬╬╦╬╬╬╩╩╬╩╦╣   ╔╬╩╦╬═╦╬╬╬╦╬╬╝╣╠╩╬╗        
       ║   ║ ╔╩╬╗╚╬╦═╦╬╣╠╬╬╬╬╣║  ╚╡╚╣    ║ ╨╠═╩╣║╠╬╬╬╗╔╬╦╬╩╡       
     ╔═╬╦╗╔╬╦╬═╩╦═╬╬╦╣╚╩╬╬╩╬╬╬╬╣    ╨   ╥║╗╦╩╦╦╩╣╠╩╬╩╬╩╩╣╨         
   ╔═╬╣╨╣╠╬╬╬╬═╦╬╬╬╦╣╩╡ ╚╬╦╦╣╠╦╗        ║╠╩╬╦╬╬╦╬╣╩╬╦╣ ╔╣          
    ╔╣╔╦╣╠╬╣╠╬╦╣╬╬╣╠╬╦╗  ╠╣╬╦═╬╣        ╠╬╗╠╝╬╬╣╠╝ ║║╨╬╬╬╗╦        
 ╣ ╥╠╣╠╬╬╩╣╝╨╬╩╩╬╬╬╬╬╡╠╗╔╬╦╩╡ ╚╣       ╚╬╝╠╬╦╬╣║  ╞╬╦═╬╩╦╬╣        
╔╬╦╦╣╬╝╠╚═╣  ╝  ║╠╩╣╬╦╣╠╩╣╨╬   ╨        ╠╦╩╝╠╬╣╝   ╣╠╦║╔╠╣╨╔╡      
║╝╠╩╩╝ ╔╦╦╝      ╨╦╬╬╬╬╬╦╣              ╠╩╦╦╣╩╬╗  ╔╩╬╩╬╬╣╠╦╣       
║ ╚   ╞╬╬╝        ═╩╦╬╝╠╬╣             ╔╬╦╬╩╩═╬╬╦═╣╔╝ ╚═╩╩╬╬╗  ╥ ╥ 
       ╠╨           ╠╩╡╬╩╬             ╠╬╩║    ╠╩╗╠╬╗╬  ╔═╬╦╬╦╦╝╔╣ 
                    ╚╩               ╔╦╬╬═╣  ╔╔╬╦╣╬╬╦╣╔╦╬═╩╩╝╨╚╦╣║ 
                                    ╔╩╝╚╩═╬══╩╩╬╬╔╩╬═╩╣╬╝      ╠╝╠╝
                                   ╞╝     ║    ╚╬╩╗╨  ╨╠     ╔═╬╦╣ 
                                          ║     ╬ ╠╝         ╨ ╚╬╦ 
                                          ╚      ╞╝            ╠╩╗ 
                                                                 ╨ 

